
0000000000
0111111310
0111113110
0111411210
0111111110
0111111110
0111111110
0111111110
0111111110
0000000000