00000000000
03111111120
02121141110
01131111410
01111211110
01111131110
01111111110
01113111110
01111111110
01111111110
00000000000
