
0000000000
0211111110
0141111110
0112111110
0111311110
0111111110
0111111110
0111111110
0111111110
0000000000